12
.
000000011111
000000111111
000001112222
011111122222
022222222222
022222222222
033333333333
033333333333
033333333333
044444444444
044444444444
000000000000